00,00,00,00,00,00,00,00,00,00,00,00,00,00,00,00,00,00,00,00,00,00,00,00,00,00,00,00,00,00,00,00
00,00,00,00,00,00,00,00,00,00,00,00,00,00,00,00,00,00,00,00,00,00,00,00,00,00,00,00,00,00,00,00
00,00,00,00,00,00,00,00,00,00,00,00,00,00,00,00,00,00,00,00,00,00,00,00,00,00,00,00,00,00,00,00
00,00,00,00,00,00,00,00,00,00,00,00,00,00,00,00,00,00,00,00,00,00,00,00,00,00,00,00,00,00,00,00
00,00,00,00,00,00,00,00,00,00,00,00,00,00,00,00,00,00,00,00,00,00,00,00,00,00,00,00,00,00,00,00
00,00,00,00,00,00,00,00,00,00,01,00,00,00,00,00,00,00,00,00,00,01,00,00,00,00,00,00,00,00,00,00
00,00,00,00,00,00,00,00,00,01,02,01,00,00,00,00,00,00,00,00,01,02,01,00,00,00,00,00,00,00,00,00
00,00,00,00,00,00,00,00,01,02,02,02,01,00,00,00,00,00,00,01,02,02,02,01,00,00,00,00,00,00,00,00
00,00,00,01,00,00,00,00,00,01,02,01,00,00,00,00,00,00,00,00,01,02,01,00,00,00,00,00,01,00,00,00
00,00,01,02,01,00,00,00,00,00,01,00,00,00,00,00,00,00,00,00,00,01,00,00,00,00,00,01,02,01,00,00
00,01,02,02,02,01,00,00,00,00,00,00,00,00,00,00,00,00,00,00,00,00,00,00,00,00,01,02,02,02,01,00
00,00,01,02,01,00,00,00,00,00,01,00,00,00,00,00,00,00,00,00,00,01,00,00,00,00,00,01,02,01,00,00
00,00,00,01,00,00,00,00,00,01,02,01,00,00,00,00,00,00,00,00,01,02,01,00,00,00,00,00,01,00,00,00
00,00,00,00,00,00,00,00,01,02,02,02,01,00,00,00,00,00,00,01,02,02,02,01,00,00,00,00,00,00,00,00
00,00,00,00,00,00,00,00,00,01,02,01,00,00,00,00,00,00,00,00,01,02,01,00,00,00,00,00,00,00,00,00
00,00,00,00,00,00,00,00,00,00,01,00,00,00,00,00,00,00,00,00,00,01,00,00,00,00,00,00,00,00,00,00
00,00,00,00,00,00,00,00,00,00,00,00,00,00,00,00,00,00,00,00,00,00,00,00,00,00,00,00,00,00,00,00
00,00,00,00,00,00,00,00,00,00,00,00,00,00,00,00,00,00,00,00,00,00,00,00,00,00,00,00,00,00,00,00
