00,00,00,00,00,00,00,00,00,00,00,00,00,00,00,00,00,00,00,00,00,00,00,00,00,00,00,00,00,00,00,00
00,00,00,00,00,00,00,00,00,00,00,00,00,00,00,00,00,00,00,00,00,00,00,00,00,00,00,00,00,00,00,00
00,00,00,00,00,00,00,01,01,01,01,01,01,01,05,05,05,05,01,01,01,01,01,01,01,00,00,00,00,00,00,00
00,00,00,00,00,00,00,01,03,00,00,00,00,00,00,00,00,00,00,00,00,00,00,04,01,00,00,00,00,00,00,00
00,00,00,00,00,00,00,01,00,00,00,00,00,00,00,00,00,00,00,00,00,00,00,00,01,00,00,00,00,00,00,00
00,00,00,00,00,00,00,01,00,00,00,00,00,00,00,00,00,00,00,00,00,00,00,00,01,00,00,00,00,00,00,00
00,00,00,00,00,00,00,01,00,00,00,00,01,01,01,00,00,01,01,01,00,00,00,00,01,00,00,00,00,00,00,00
00,00,00,00,00,00,00,01,00,00,00,00,01,02,00,00,00,00,02,01,00,00,00,00,01,00,00,00,00,00,00,00
00,00,00,00,00,00,00,05,00,00,00,00,01,00,00,00,00,00,00,01,00,00,00,00,05,00,00,00,00,00,00,00
00,00,00,00,00,00,00,05,00,00,00,00,00,00,00,00,00,00,00,00,00,00,00,00,05,00,00,00,00,00,00,00
00,00,00,00,00,00,00,05,00,00,00,00,00,00,00,00,00,00,00,00,00,00,00,00,05,00,00,00,00,00,00,00
00,00,00,00,00,00,00,05,00,00,00,00,01,00,00,00,00,00,00,01,00,00,00,00,05,00,00,00,00,00,00,00
00,00,00,00,00,00,00,01,00,00,00,00,01,02,00,00,00,00,02,01,00,00,00,00,01,00,00,00,00,00,00,00
00,00,00,00,00,00,00,01,00,00,00,00,01,01,01,00,00,01,01,01,00,00,00,00,01,00,00,00,00,00,00,00
00,00,00,00,00,00,00,01,00,00,00,00,00,00,00,00,00,00,00,00,00,00,00,00,01,00,00,00,00,00,00,00
00,00,00,00,00,00,00,01,00,00,00,00,00,00,00,00,00,00,00,00,00,00,00,00,01,00,00,00,00,00,00,00
00,00,00,00,00,00,00,01,03,00,00,00,00,00,00,00,00,00,00,00,00,00,00,04,01,00,00,00,00,00,00,00
00,00,00,00,00,00,00,01,01,01,01,01,01,01,05,05,05,05,01,01,01,01,01,01,01,00,00,00,00,00,00,00
